chimera tag	similar tag with HD=0
AAAAAAAAAAAA AACCAAAACTTC	*AAAAAAAAAAAA* TCTTTCTTTGAG
AAAAAAAAAAAA ACCAGGCGTCGA	*AAAAAAAAAAAA* AACCAAAACTTC, *AAAAAAAAAAAA* AGCTCCACGTTG, *AAAAAAAAAAAA* CAGTGTTGAGAC, *AAAAAAAAAAAA* TCTTTCTTTGAG, *AAAAAAAAAAAA* TTGGGTTCCTTA
AAAAAAAAAAAA AGCTCCACGTTG	*AAAAAAAAAAAA* CAGTGTTGAGAC, *AAAAAAAAAAAA* CCGCTCCTCACA
AAAAAAAAAAAA ATCGTGGTTTGT	*AAAAAAAAAAAA* CAGTGTTGAGAC, AAAAAAAAAAAG *ATCGTGGTTTGT*
AAAAAAAAAAAA ATTCACCCTTGT	*AAAAAAAAAAAA* CAGTGTTGAGAC, AAAAAAAAAAAT *ATTCACCCTTGT*
AAAAAAAAAAAA CACACTTAACTT	*AAAAAAAAAAAA* ATTCACCCTTGT, *AAAAAAAAAAAA* CCGCTCCTCACA, *AAAAAAAAAAAA* TCTTTCTTTGAG
AAAAAAAAAAAA CAGTGTTGAGAC	*AAAAAAAAAAAA* ATCGTGGTTTGT, *AAAAAAAAAAAA* ATTCACCCTTGT, *AAAAAAAAAAAA* CACACTTAACTT
AAAAAAAAAAAA CCGCTCCTCACA	*AAAAAAAAAAAA* AGCTCCACGTTG, *AAAAAAAAAAAA* CACACTTAACTT
AAAAAAAAAAAA GGCAACACAGAA	*AAAAAAAAAAAA* ATCGTGGTTTGT, AAAAAAAAAAAG *GGCAACACAGAA*
AAAAAAAAAAAA TCTTTCTTTGAG	*AAAAAAAAAAAA* AACCAAAACTTC, AAAAAAAAAAAG *TCTTTCTTTGAG*
AAAAAAAAAAAA TTGGGTTCCTTA	*AAAAAAAAAAAA* ACCAGGCGTCGA, *AAAAAAAAAAAA* GGCAACACAGAA, *AAAAAAAAAAAA* TCTTTCTTTGAG
AAAAAAAAAAAG AGTCGCACCCAG	*AAAAAAAAAAAG* ATCGTGGTTTGT
AAAAAAAAAAAG ATCGTGGTTTGT	AAAAAAAAAAAA *ATCGTGGTTTGT*, *AAAAAAAAAAAG* TAGCCCTAAACG
AAAAAAAAAAAG CGCAACACAGAA	*AAAAAAAAAAAG* ATCGTGGTTTGT
AAAAAAAAAAAG GGCAACACAGAA	AAAAAAAAAAAA *GGCAACACAGAA*, *AAAAAAAAAAAG* ATCGTGGTTTGT
AAAAAAAAAAAG TAGCCCTAAACG	*AAAAAAAAAAAG* ATCGTGGTTTGT
AAAAAAAAAAAG TCTTTCTTTGAG	AAAAAAAAAAAA *TCTTTCTTTGAG*, *AAAAAAAAAAAG* ATCGTGGTTTGT, *AAAAAAAAAAAG* CGCAACACAGAA, *AAAAAAAAAAAG* GGCAACACAGAA
AAAAAAAAAAAT ATCATAGACTCT	*AAAAAAAAAAAT* ATTCACCCTTGT
AAAAAAAAAAAT ATTCACCCTTGT	AAAAAAAAAAAA *ATTCACCCTTGT*, *AAAAAAAAAAAT* ATCATAGACTCT
AAAAAAAAAAAT ATTCGAAAGTTA	*AAAAAAAAAAAT* ATCATAGACTCT, *AAAAAAAAAAAT* ATTCACCCTTGT
This file contains all tags that were identified as chimeras as the first column and the corresponding tags which returned a Hamming distance of zero in either the first or the second half of the sample tag as the second column.
 The tags were separated by an empty space into their halves and the * marks the identical half.